1111111111111111111111111
1E00000000000000000000001
1010010100100000101001001
1111010010101010001001001
1PC0000000000000000000001
1111111111111111111111111
1111111111111111111111111
1111111111111111111111111
