111111111
111P11111
11111C111
111E11111
111111111